┌┐┐┐┐┐┐┐┐┐┐┐┐┐.......................┌┌┌┌┌┌┌┌┌┌┌┌┐
└┘│┌┐┐┐┐┐┐┐┐┐┐.......................│││││││││││└┘
└─┘└┘┘┘┘┘┘┘┘┘┘.......................││││││││││└─┘
└──┘││┌─┐─┐─┐─┐......................│││││││││└──┘
└───┘││││││││││......................││││││││└───┘
└────┘└─┘─┘─┘─┘┌───┐.................│││││││└────┘
└─────┘││││││┌──┐┐.│.................││││││└─────┘
└──────┘││││││││││.│.................│││││└──────┘
└───────┘│││││││││.│.................││││└───────┘
└────────┘│││└──┘┘─┘.................│││└─┌──┐───┘
└─────────┘│││.......................││└──│──│───┘
└──────────┘││.......................│└───│──│───┘
└───────────┘│.......................└────└──┘───┘
└────────────┘............................└──┘....
..........................................└──┘....
..........................................└──┘....
..................................................
..................................................
..................................................
..................................................